11111111111111111111111111111111111
10000010000001000000000100000000001
100P001000T0010T0000000100000000001
10000010000001000000000100000000001
10000C100C000100000000010000T000001
100C0010CSC001000000000100000000001
100C0010C0000100T0000001000000T0001
100T0010E00001000000000100000000001
11111111111111111111111111111111111
