11111111111111111111111111111111111
100T0010000001000000000100000000001
100P001000T0010T0000000100000000001
10000010000001000000000100T00000001
10000C100C0001000000000100000000001
100C0010CSC0010000000001000T0000001
100C0010C00T010000T0000100000000001
10000010E00001000000000100000000001
11111111111111111111111111111111111
