11111111111111111111111
1C000000000000100000001
1000000000000000000C001
11011100S0111100C000001
1E00000000111100000S001
111111110S01C100P000001
1000000000000100C000001
10C0000000000100E000001
11000S1111111100000C001
1000C100000C00000000001
11111111111111111111111
