1111111111111111
10T011100P00T001
1CCC10C0T00S0101
10E010T00S00CC01
10001C0000S01001
1111111111111111
